16 16 16 16 16 16 16 16 16 16 16 16 16 16 16 16 16 16 16 16 16 16 16 16 16 16 16 16 16 16 16 16 16 16 16 16 16 16 16 16 16 0 0 16 16 16 2 16 16 16 
16 2 2 2 2 2 2 2 2 2 2 2 2 2 2 2 2 2 2 9 16 2 2 2 2 2 2 2 2 2 2 2 2 2 2 2 2 2 2 9 16 0 0 16 2 2 2 2 2 16 
16 2 2 2 2 2 2 2 2 2 2 2 2 2 2 2 2 2 2 10 16 2 2 2 2 2 2 2 2 2 2 2 2 2 2 2 2 2 2 10 16 0 0 16 2 2 2 2 2 16 
16 2 2 2 2 2 2 2 2 2 2 2 2 2 2 2 2 2 2 2 16 2 2 2 2 2 2 2 2 2 2 2 2 2 2 2 2 2 2 2 16 0 0 16 2 2 2 2 2 16 
16 2 2 2 2 2 2 2 2 2 2 2 2 2 2 2 2 2 2 2 16 2 2 2 2 2 2 2 2 2 2 2 2 2 2 2 2 2 2 2 16 0 0 16 2 2 2 2 2 16 
16 2 2 2 2 2 2 2 2 2 2 2 2 2 2 2 2 2 2 2 16 2 2 2 2 2 2 2 2 2 2 2 2 2 2 2 2 2 2 2 16 0 0 16 2 2 2 2 2 16 
16 2 2 2 16 16 11 16 16 16 16 16 16 16 16 16 16 16 16 16 16 2 2 2 16 16 11 16 16 16 16 16 16 16 16 16 16 16 16 16 16 0 0 16 2 2 2 2 2 16 
16 2 2 2 16 2 2 2 2 2 2 2 2 2 2 11 3 3 3 3 16 2 2 2 16 2 2 2 2 2 2 2 2 2 2 11 3 3 3 3 16 0 0 16 2 2 2 2 2 16 
16 2 2 2 16 2 2 2 2 2 2 2 2 2 2 16 3 3 3 3 16 2 2 2 16 2 2 2 2 2 2 2 2 2 2 16 3 3 3 3 16 0 0 16 2 2 2 2 2 16 
16 2 2 2 16 2 2 2 2 2 2 2 2 2 2 16 3 3 3 3 16 2 2 2 16 2 2 2 2 2 2 2 2 2 2 16 3 3 3 3 16 0 0 16 2 2 2 2 2 16 
16 2 2 2 16 2 2 2 2 2 2 2 2 2 2 16 3 3 3 3 16 2 2 2 16 2 2 2 2 2 2 2 2 2 2 16 3 3 3 3 16 0 0 16 2 2 2 2 2 16 
16 2 2 2 16 2 2 2 2 2 2 2 2 2 2 16 3 3 3 3 16 2 2 2 16 2 2 2 2 2 2 2 2 2 2 16 3 3 3 3 16 0 0 16 2 2 2 2 2 16 
16 16 11 16 16 16 16 16 16 16 16 16 16 16 16 16 16 16 16 16 16 16 11 16 16 16 16 16 16 16 16 16 16 16 16 16 16 16 16 16 16 16 16 16 2 2 2 2 2 16 
16 2 2 2 2 2 2 2 2 2 2 2 2 2 2 2 2 2 2 2 2 2 2 2 2 2 2 2 2 2 2 2 2 2 2 2 2 2 2 2 2 2 2 2 2 2 2 2 2 16 
16 2 2 2 2 2 2 2 2 2 2 2 2 2 2 2 2 2 2 2 2 2 2 2 2 2 2 2 2 2 2 2 2 2 2 2 2 2 2 2 2 2 2 2 2 2 2 2 2 16 
16 2 2 2 2 2 2 2 2 2 2 2 2 2 2 2 2 2 2 2 2 2 2 2 2 2 2 2 2 2 2 2 2 2 2 2 2 2 2 2 2 2 2 2 2 2 2 2 2 16 
16 16 11 16 16 16 16 16 16 16 16 16 16 16 16 16 16 16 16 16 16 16 11 16 16 16 16 16 16 16 16 16 16 16 16 16 16 16 16 16 16 16 16 16 2 2 2 2 2 16 
16 2 2 2 16 2 2 2 2 2 2 2 2 2 2 16 3 3 3 3 16 2 2 2 16 2 2 2 2 2 2 2 2 2 2 16 3 3 3 3 16 0 0 16 2 2 2 2 2 16 
16 2 2 2 16 2 2 2 2 2 2 2 2 2 2 16 3 3 3 3 16 2 2 2 16 2 2 2 2 2 2 2 2 2 2 16 3 3 3 3 16 0 0 16 2 2 2 2 2 16 
16 2 2 2 16 2 2 2 2 2 2 2 2 2 2 16 3 3 3 3 16 2 2 2 16 2 2 2 2 2 2 2 2 2 2 16 3 3 3 3 16 0 0 16 2 2 2 2 2 16 
16 2 2 2 16 2 2 2 2 2 2 2 2 2 2 16 3 3 3 3 16 2 2 2 16 2 2 2 2 2 2 2 2 2 2 16 3 3 3 3 16 0 0 16 2 2 2 2 2 16 
16 2 2 2 16 2 2 2 2 2 2 2 2 2 2 11 3 3 3 3 16 2 2 2 16 2 2 2 2 2 2 2 2 2 2 11 3 3 3 3 16 0 0 16 2 2 2 2 2 16 
16 2 2 2 16 16 11 16 16 16 16 16 16 16 16 16 16 16 16 16 16 2 2 2 16 16 11 16 16 16 16 16 16 16 16 16 16 16 16 16 16 0 0 16 2 2 2 2 2 16 
16 2 2 2 2 2 2 2 2 2 2 2 2 2 2 2 2 2 2 9 16 2 2 2 2 2 2 2 2 2 2 2 2 2 2 2 2 2 2 9 16 0 0 16 2 2 2 2 2 16 
16 2 2 2 2 2 2 2 2 2 2 2 2 2 2 2 2 2 2 10 16 2 2 2 2 2 2 2 2 2 2 2 2 2 2 2 2 2 2 10 16 0 0 16 2 2 2 2 2 16 
16 2 2 2 2 2 2 2 2 2 2 2 2 2 2 2 2 2 2 2 16 2 2 2 2 2 2 2 2 2 2 2 2 2 2 2 2 2 2 2 16 0 0 16 2 2 2 2 2 16 
16 2 2 2 2 2 2 2 2 2 2 2 2 2 2 2 2 2 2 2 16 2 2 2 2 2 2 2 2 2 2 2 2 2 2 2 2 2 2 2 16 0 0 16 2 2 2 2 2 16 
16 2 2 2 2 2 2 2 2 2 2 2 2 2 2 2 2 2 2 2 16 2 2 2 2 2 2 2 2 2 2 2 2 2 2 2 2 2 2 2 16 0 0 16 2 2 2 2 2 16 
16 16 16 16 16 16 16 16 16 16 16 16 16 16 16 16 16 16 16 16 16 16 16 16 16 16 16 16 16 16 16 16 16 16 16 16 16 16 16 16 16 16 16 16 2 2 2 2 2 16 
16 14 14 14 14 14 14 14 14 14 14 14 14 14 14 14 14 14 14 14 14 14 14 14 14 14 14 14 14 14 14 14 14 14 14 14 14 14 14 14 14 14 14 16 2 2 2 2 2 16 
16 14 14 14 14 14 14 14 14 14 14 14 14 14 14 14 14 14 14 14 14 14 14 14 14 14 14 14 14 14 14 14 14 14 14 14 14 14 14 14 14 14 14 16 2 2 2 2 2 16 
16 14 14 14 14 14 14 14 14 14 14 14 14 14 14 14 14 14 14 14 14 14 14 14 14 14 14 14 14 14 14 14 14 14 14 14 14 14 14 14 14 14 14 16 2 2 2 2 2 16 
16 14 14 14 16 16 16 16 16 16 16 16 16 14 14 14 16 16 16 16 16 16 16 16 16 16 16 16 14 14 14 16 16 16 16 16 16 16 16 16 16 11 16 16 2 2 2 2 2 16 
16 14 14 14 16 0 0 0 0 0 0 0 16 14 14 14 16 0 0 0 0 0 0 0 0 0 0 16 14 14 14 16 0 0 0 0 0 0 0 16 2 2 2 2 2 2 2 2 2 16 
16 14 14 14 16 0 0 0 0 0 0 0 16 14 14 14 16 0 0 0 0 0 0 0 0 0 0 16 14 14 14 16 0 0 0 0 0 0 0 16 2 2 2 2 2 2 2 2 2 16 
16 14 14 14 16 0 0 0 0 0 0 0 16 14 14 14 16 0 0 0 0 0 0 0 0 0 0 16 14 14 14 16 0 0 0 0 0 0 0 16 2 2 2 2 2 2 2 2 2 16 
16 14 14 14 16 16 16 16 16 16 16 16 16 14 14 14 16 16 16 16 16 16 16 16 16 16 16 16 14 14 14 16 16 16 16 16 16 16 16 16 16 11 16 16 2 2 2 2 2 16 
16 14 14 14 14 14 14 14 14 14 14 14 14 14 14 14 14 14 14 14 14 14 14 14 14 14 14 14 14 14 14 14 14 14 14 14 14 14 14 14 14 14 14 16 2 2 2 2 2 16 
16 14 14 14 14 14 14 14 14 14 14 14 14 14 14 14 14 14 14 14 14 14 14 14 14 14 14 14 14 14 14 14 14 14 14 14 14 14 14 14 14 14 14 16 2 2 2 2 2 16 
16 14 14 14 14 14 14 14 14 14 14 14 14 14 14 14 14 14 14 14 14 14 14 14 14 14 14 14 14 14 14 14 14 14 14 14 14 14 14 14 14 14 14 16 2 2 2 2 2 16 
16 16 16 16 16 16 16 16 16 16 16 16 16 16 16 16 16 16 16 16 16 16 16 16 16 16 16 16 16 16 16 16 16 16 16 16 16 16 16 16 16 16 16 16 16 16 11 16 16 16 
16 14 14 14 14 14 16 12 12 12 12 12 12 12 12 12 12 12 12 12 12 12 12 12 12 12 12 12 12 12 12 12 12 12 12 12 12 12 12 12 12 12 12 12 4 4 4 4 4 6 
16 14 14 14 14 14 11 4 4 4 4 4 4 4 4 4 4 4 4 4 4 4 4 4 4 4 4 4 4 4 4 4 4 4 4 4 4 4 4 4 4 4 4 4 4 4 4 4 4 6 
16 14 14 14 14 14 16 12 12 12 12 12 12 12 12 12 12 12 12 12 12 12 12 12 12 12 12 12 12 12 12 12 12 12 12 12 12 12 12 12 12 12 12 12 4 4 4 4 4 6 
16 14 14 14 14 14 16 4 4 4 4 4 12 4 4 4 4 4 4 4 4 4 12 4 4 4 4 4 4 4 4 4 12 4 4 4 4 4 12 4 4 4 4 12 4 4 4 4 4 6 
16 14 14 14 14 14 16 4 4 4 12 4 12 4 12 12 12 4 12 4 12 4 4 4 12 12 12 12 12 4 12 4 12 4 12 12 12 4 12 4 12 4 4 4 4 4 4 4 4 6 
16 14 14 14 14 14 16 4 4 4 12 4 12 4 4 4 12 4 12 4 12 4 12 12 12 4 4 4 4 4 12 4 12 4 12 4 4 4 12 4 12 4 4 12 4 4 4 4 4 6 
16 14 14 14 14 14 16 4 4 4 12 4 12 12 12 12 12 12 12 4 12 4 12 4 4 4 12 12 12 4 12 4 4 4 12 4 12 12 12 4 12 4 4 12 4 4 4 4 4 6 
16 14 14 14 14 14 16 4 4 4 12 4 4 4 4 4 4 4 4 4 12 4 12 4 12 4 4 4 4 4 12 4 12 12 12 4 4 4 4 4 12 4 4 12 4 4 4 4 4 6 
16 16 16 16 16 16 16 5 5 5 5 5 5 5 5 5 5 5 5 5 5 5 5 5 5 5 5 5 5 5 5 5 5 5 5 5 5 5 5 5 5 5 5 5 5 5 5 5 5 8 
