16 16 16 16 16 16 16 16 16 16 16 16 16 16 16 16 16 16 16 16 16 16 16 16 16 16 16 16 16 16 16 16 16 16 16 16 16 16 16 16 16 0 0 16 16 16 16 16 16 16 
16 2 0 0 2 2 2 2 2 2 2 2 2 2 2 2 2 2 2 2 16 2 2 2 2 2 2 2 2 2 2 0 2 2 2 2 2 2 2 9 16 0 0 16 2 2 2 2 2 16 
16 2 2 0 2 2 2 13 2 2 2 2 9 2 13 2 13 2 2 2 16 2 2 2 2 2 2 2 0 2 2 0 2 2 2 2 2 2 2 10 16 0 0 16 2 2 2 2 2 16 
16 13 0 0 0 0 2 2 2 2 2 2 2 13 13 13 13 2 2 2 16 2 2 2 2 2 1 0 0 2 2 0 2 2 2 2 2 2 2 2 16 0 0 16 2 2 2 2 2 16 
16 13 0 0 2 2 2 2 2 2 13 2 13 13 2 10 2 13 2 2 16 2 2 2 2 1 0 0 2 2 2 0 2 2 2 2 2 2 2 2 16 0 0 16 2 2 2 2 2 16 
16 2 2 2 2 2 2 2 2 2 2 2 2 2 2 2 2 2 2 2 16 2 2 2 1 0 0 2 2 2 13 2 2 2 2 2 2 13 2 2 16 0 0 16 2 2 2 2 2 16 
16 2 2 2 16 16 11 16 16 16 16 16 16 16 16 16 16 16 16 16 16 2 2 2 16 16 11 16 16 16 16 16 16 16 16 16 16 13 13 16 16 0 0 16 2 2 2 2 2 16 
16 2 2 2 16 2 2 2 2 2 2 2 2 2 2 11 3 3 3 3 16 2 2 2 16 2 2 2 2 2 2 13 13 2 2 11 3 0 13 3 16 0 0 16 2 2 2 2 2 16 
16 2 2 2 16 2 2 2 2 2 2 2 2 2 2 16 3 3 3 3 16 2 2 2 16 2 2 2 2 0 2 2 13 2 2 16 3 0 3 3 16 0 0 16 2 2 2 2 2 16 
16 2 2 2 16 2 2 2 2 0 0 0 2 2 2 16 13 13 13 3 16 2 2 2 16 2 2 2 0 0 0 2 2 2 2 16 3 0 3 3 16 0 0 16 2 0 2 2 2 16 
16 2 2 2 16 2 2 2 0 0 0 13 13 2 2 16 3 13 13 0 16 2 2 2 16 2 2 0 0 0 0 2 2 2 2 16 3 3 3 3 16 0 0 16 2 0 0 2 2 16 
16 2 2 2 16 2 2 2 2 2 2 2 2 2 2 16 3 3 0 0 16 2 2 2 16 2 2 2 2 2 2 2 2 2 2 16 3 3 3 3 16 0 0 16 2 2 0 0 2 16 
16 16 11 16 16 16 16 16 16 16 16 16 16 16 16 16 16 16 16 16 16 16 11 16 16 16 16 16 16 16 16 16 16 16 16 16 16 16 16 16 16 16 16 16 2 2 0 0 0 16 
16 2 2 2 2 2 2 2 2 2 13 2 2 2 0 0 0 0 0 0 0 2 2 2 2 2 2 2 2 2 2 2 2 2 2 2 2 2 2 2 2 2 2 2 2 2 0 0 0 16 
16 2 13 13 13 13 2 2 2 2 13 2 2 0 0 0 0 0 0 0 0 0 2 2 2 2 2 2 2 2 2 2 2 0 2 2 2 2 2 2 2 2 2 2 2 2 0 0 0 16 
16 2 2 2 13 13 2 2 13 13 13 2 0 0 0 0 0 0 0 0 0 2 2 2 2 2 2 2 2 2 2 2 0 0 2 2 2 2 2 2 2 2 2 2 2 2 2 0 0 16 
16 16 11 16 16 16 16 16 16 16 16 16 16 16 16 16 16 16 16 16 16 16 11 16 16 16 16 16 16 16 16 0 0 16 16 16 16 16 16 16 16 16 16 16 16 16 16 16 16 16 
16 2 2 2 16 2 2 2 2 2 2 2 2 2 2 16 3 3 3 3 16 2 2 2 16 2 2 2 2 2 0 0 2 2 2 16 3 0 16 16 16 0 0 0 0 0 0 0 0 16 
16 2 2 2 16 2 2 13 2 2 13 13 2 2 2 16 3 13 3 3 16 2 2 2 16 2 2 2 2 0 0 2 2 2 2 16 3 0 16 16 16 0 0 0 0 0 0 0 0 16 
16 13 13 2 16 2 2 2 2 2 13 13 13 2 2 16 3 13 13 3 16 2 2 2 16 2 2 2 0 0 0 0 2 2 2 16 13 3 3 3 16 0 0 0 0 0 0 0 0 16 
16 2 13 2 16 2 2 13 13 13 13 13 2 2 2 16 3 13 13 3 16 2 2 2 16 2 2 2 0 0 0 2 2 2 2 16 13 13 13 3 16 0 0 0 0 0 0 0 0 16 
16 2 2 2 16 2 2 2 2 2 2 2 2 2 2 11 3 3 3 3 16 2 2 2 16 2 2 2 2 2 2 2 2 2 2 11 3 3 13 3 16 0 0 0 0 0 0 0 0 16 
16 2 2 2 16 16 11 16 16 16 16 16 16 16 16 16 16 16 16 16 16 2 2 2 16 16 11 16 16 16 16 16 16 16 16 16 16 16 16 16 16 0 0 0 0 0 0 0 0 16 
16 2 0 2 2 13 2 2 2 2 2 2 2 2 2 2 2 2 2 9 16 2 2 2 2 2 2 2 13 13 16 2 2 2 2 2 2 2 2 9 16 0 0 0 0 0 0 0 0 16 
16 2 0 0 2 13 2 2 2 2 0 0 2 2 2 2 2 2 2 10 16 2 2 2 2 2 2 2 13 13 16 2 2 0 2 2 2 2 2 10 16 0 0 16 16 16 16 16 16 16 
16 2 2 0 13 13 2 0 0 0 0 13 2 2 2 2 2 2 2 2 13 16 2 2 2 2 2 2 2 13 16 2 2 16 2 2 2 2 2 2 13 13 13 13 2 2 2 2 2 16 
16 2 2 2 13 13 0 0 13 13 13 13 2 2 2 2 2 2 2 2 13 2 2 2 2 16 0 16 2 2 13 0 2 2 2 2 2 2 2 2 13 13 13 13 2 16 2 2 2 16 
16 2 2 2 13 2 2 2 2 2 2 2 2 2 2 2 2 2 2 16 13 2 2 2 2 2 0 0 0 2 2 2 2 2 2 2 2 2 2 2 13 13 16 13 16 2 2 2 2 16 
16 16 16 16 16 16 16 16 16 16 16 16 16 16 16 16 16 16 16 16 16 16 16 16 16 16 16 16 16 16 16 16 16 16 16 16 16 16 16 16 16 16 16 16 2 2 2 2 2 16 
16 14 14 14 14 14 14 14 14 14 13 13 0 0 0 0 0 0 13 14 14 14 14 14 13 13 13 13 14 14 14 14 14 14 14 14 14 14 13 13 0 0 0 16 2 2 2 2 2 16 
14 14 14 14 14 14 14 14 14 13 13 0 0 0 0 0 0 13 14 14 14 14 14 14 14 14 14 13 13 14 14 14 14 14 14 14 14 14 13 13 0 0 0 16 2 2 2 0 0 16 
16 14 14 14 14 14 14 14 14 13 0 0 0 0 13 13 13 14 14 14 14 14 14 14 14 14 14 14 13 13 14 14 14 14 14 14 14 14 13 13 0 0 0 16 2 2 0 0 13 16 
16 14 14 14 16 16 16 16 16 16 16 16 16 13 14 14 16 16 16 16 16 16 16 16 16 16 16 16 14 13 14 16 16 16 16 16 16 16 16 16 16 0 16 16 2 2 0 0 2 16 
16 14 14 14 16 0 0 0 0 0 0 0 16 14 14 14 16 0 0 0 0 0 0 0 0 0 0 16 14 14 14 16 0 0 0 0 0 0 0 16 13 16 13 2 2 0 0 13 2 16 
16 14 14 14 16 0 0 0 0 0 0 0 16 14 14 14 16 0 0 0 0 0 0 0 0 0 0 16 14 14 14 16 0 0 0 0 0 0 0 16 13 13 13 2 2 0 13 2 2 16 
16 14 14 14 16 0 0 0 0 0 0 0 16 13 14 14 16 0 0 0 0 0 0 0 0 0 0 16 14 14 14 16 0 0 0 0 0 0 0 16 2 2 2 2 2 2 13 2 2 16 
16 14 14 14 16 16 16 16 16 16 16 16 16 14 14 14 16 16 16 16 16 16 16 16 16 16 16 16 14 14 14 16 16 16 16 16 16 16 16 16 16 11 16 16 2 2 13 13 2 16 
16 14 14 14 14 14 14 0 0 13 13 14 14 14 14 14 16 14 14 14 14 13 14 14 14 14 13 0 13 13 13 14 14 14 14 14 14 14 14 14 14 14 14 16 2 2 2 13 2 16 
16 14 14 14 14 14 14 0 13 13 14 14 14 14 14 13 16 16 16 13 14 14 13 14 14 14 13 0 0 0 13 13 14 14 14 14 14 14 14 14 14 14 14 16 2 2 2 2 2 16 
16 14 14 14 14 14 14 14 14 14 14 14 14 14 14 13 14 14 16 14 14 14 14 14 14 14 13 13 13 0 0 13 14 14 14 14 14 14 14 14 14 14 14 16 2 2 2 2 2 16 
16 16 16 16 16 16 16 16 16 16 16 16 16 16 16 16 16 16 16 16 16 16 16 16 16 16 16 16 16 16 16 16 16 16 16 16 16 16 16 16 16 16 16 16 16 16 11 16 16 16 
16 14 14 14 14 14 16 12 12 12 12 12 12 12 12 12 12 12 12 12 12 12 12 12 12 12 12 12 12 12 12 12 12 12 12 12 12 12 12 12 12 12 12 12 4 4 4 4 4 6 
16 14 13 13 13 13 11 4 4 4 4 4 4 4 4 4 4 4 4 4 4 4 4 4 4 4 4 4 4 4 4 4 4 4 4 4 4 4 4 4 4 4 4 4 4 4 4 4 4 6 
16 14 13 0 0 13 16 12 12 12 12 12 12 12 12 12 12 12 12 12 12 12 12 12 12 12 12 12 12 12 12 12 12 12 12 12 12 12 12 12 12 12 12 12 4 4 4 4 4 6 
16 13 13 0 0 13 16 4 4 4 4 4 12 4 0 4 4 4 4 4 4 4 12 4 4 13 13 13 13 4 4 13 12 0 13 4 4 4 12 4 4 13 0 12 4 13 4 0 0 6 
16 13 0 0 13 13 16 4 4 4 12 4 12 4 0 0 12 4 12 4 12 4 4 4 13 13 0 0 13 4 12 13 13 0 12 12 12 4 12 4 12 4 0 0 4 4 0 0 13 6 
16 13 0 0 13 13 16 4 4 4 12 4 12 4 4 0 12 4 12 4 12 4 12 12 13 0 0 13 13 4 12 4 12 0 12 4 4 4 12 4 12 13 0 12 13 4 0 13 4 6 
16 13 13 13 13 14 16 4 4 4 12 4 12 12 12 0 0 12 12 4 12 4 12 4 4 13 12 13 12 4 12 4 4 13 12 4 12 12 12 4 12 4 4 12 0 0 0 13 4 6 
16 14 14 14 14 14 16 4 4 4 12 4 4 4 4 4 0 0 4 4 12 4 12 4 12 4 4 4 4 4 12 4 12 12 12 4 4 4 4 4 12 4 13 12 0 13 13 13 4 6 
16 16 16 16 16 16 16 5 5 5 5 5 5 5 5 5 5 5 5 5 5 5 5 5 5 5 5 5 5 5 5 5 5 5 5 5 5 5 5 5 5 5 5 5 5 5 5 5 5 8 
